#########################
#   #   # #     #   #   #
# # # # # # ### ### # # #
#K# #   #     #   #   # #
### # ##### ### # ##### #
#   #     #   # #     # #
# ### ### # ### ##### # #
#     # # #     #   # # #
# ### # # ### ### # # # #
#   # #     #   # #   # #
### ####### # # # ### ###
#   #     # # # # #     #
# # # ### #  ## ### ### #
# # #   #   #   #     # #
# ### # ##### ### ### # #
#   # #     #   #   # # #
# ### ##### ### ### # ###
#   #   #     #     #   #
### # # ### ### ### ### #
#   # #   #   # #   #   #
# ### ### ### # # ### # #
#   #     #   # #   # # #
### ##### ### ### ### # #
#     #     #     #   # #
###################DE####
