#########################
#   #     #       #     #
# # # ### # ### ### ### #
# #     #     #     #   #
### ### ##### # ### # # #
#   #   #   # #   # # # #
# ### ### # ### # ### # #
#     #   #     #     # #
# ### ### ### ### ### # #
#   #     # #   #     # #
### ### ### # ##### ### #
#     #     #     #     #
# ### ### ## ## ### ### #
#   #     #D   K#   #   #
### ### # ##### ### ### #
#     # #     #   #     #
# ### ##### ### ##### ###
# #     #     #   #     #
# ### # ### ### # # ### #
#   # #   #   # # # #   #
# ### ### ### ### # ### #
#   #   #     #   # #   #
# ### ##### # ### # # ###
#     #     #     #     #
#########################
